; name: Easy Start
; difficulty: easy
#####
#@$.#
#####
