; name: Hard Challenge
; difficulty: hard
######
#@ $.#
#  $ #
# . .#
######
